Tremonti - So You're Afraid
Chrysalis - Out Of My Hands
Adrenaline Mob - Feel the Adrenaline
Awake At Last - Purgatorium
The Color Morale - Walls
While She Sleeps - Silence Speaks feat. Oliver Sykes
Art Of Dying - All Or Nothing
Eye Empire - Moment
Dead Letter Circus - Next in Line
Poynte - Hold On
Of Mice & Men - Unbreakable
Throw The Fight - Bury Me Alive
I Prevail - Stuck In Your Head
I Prevail - Scars
NOTHING MORE - Go To War
Theory Of A Deadman - Rx
Alter Bridge - Wayward One
HIM - Soul on Fire
Sylar - Dark Daze
Wayland - Through The Fire
HIM - Poison Girl
A Day To Remember - Bullfight
Stealing Eden - Too Late
Wage War - Gravity
Dreamshade - Up All Night
Candlelight Red - Medicated
Falling In Reverse - Broken
Dayshell - Low Light
30 Seconds To Mars - From Yesterday
BEAST IN BLACK - Blind And Frozen (OFFICIAL VIDEO)
THUNDERMOTHER â€“ It's Just  A Tease